111111111111111111111
1111000P0000000000001
110E00000000000000001
110000000000000E11111
111111111111111111111