111111111111111111111
111100000000P00000001
1100000000000000000C1
110000000000000011111
111111111111011111111