11111111111111111
100010000000000C1
10000001111000001
1P0001111111100E1
11111111111111111