1111111111111111111111111111
111100000000C0000000C00000E1
110000000C000000001111000001
100000000000C000111111100001
1111000000C00001111111100001
1P0000000C000000111110000001
1111111111111111111111111111