11111111111111
10000P00001111
11000000000C11
111000C0000111
110C0000001111
10000000000011
1110000C000011
11000000000011
10000000C00001
111111E1111111
11111111111111