111111111111111111111
1000P00000000C0001111
1C0010000000000111111
100000000C00000001111
100000000000001111111
1000C0000000000011111
1110000000000C0001111
1111000000E0000000111
111111111111111111111