11111111111111111111111111111111111111111
10000000000C000000000000C00000000000000P1
1000C00000000000000000000000000C000000111
1E000000000000000000000C00000000000011111
11111111111111111111111111111111111111111