11111111111111111
1P000000000001111
1000000C000001111
11111100000000C01
100000C0000000011
1111C000000000011
11100000000000011
1110000000C000011
1000000C00000E111
11111111111111111