111111111111111111111111
110000C00000000000C11111
111P0000000C000000000111
1111100000000000000C1111
11100000000C000000000111
111000000000000000C11111
1110000C00000000E0000111
111111111111111111111111