11111111111111111111
110000C0000000011111
11100000000C00000111
11000000000000001111
11100000000C00000111
10000000000000011111
1110000C00000000E111
11111111111111111111