111111
1EP001
1C0001
1000C1
100001
111111